20 20
100 100
0 0 0 0 0 0 0 0 0 0 0 0 0 0 0 0 0 0 0 0
0 0 0 0 0 0 0 0 0 0 0 0 0 0 0 0 0 0 0 0
0 0 0 0 0 0 0 0 0 0 0 0 0 0 0 0 0 0 0 0
0 0 0 0 0 0 0 0 0 0 0 0 0 0 0 0 0 10 0 0
0 0 0 0 0 0 0 0 0 0 2 0 0 0 0 0 0 10 10 0
0 0 2 2 0 0 0 0 0 0 0 0 0 0 0 0 0 10 0 0
0 0 0 0 0 0 0 0 0 0 0 0 0 0 0 0 0 0 0 0
0 0 0 0 0 0 0 0 0 0 0 0 0 0 0 0 10 10 0 0
0 0 0 0 0 0 0 0 0 99 0 0 0 0 0 10 10 10 10 0
0 0 2 0 0 0 0 0 0 0 0 0 0 0 0 0 10 10 0 0
0 0 0 0 0 0 0 0 0 0 0 2 0 0 0 0 0 0 0 0
0 0 0 0 0 0 0 0 0 0 0 0 0 0 0 0 0 0 0 0
0 0 0 0 0 0 0 0 0 0 0 0 1 1 1 0 0 0 0 0
0 0 0 0 0 0 0 0 0 0 0 0 1 1 0 0 10 10 0 0
0 0 1 0 0 0 0 0 0 0 0 0 1 0 0 0 0 10 0 0
0 0 1 1 0 0 0 0 0 0 0 0 0 0 0 0 0 0 0 0
0 0 1 0 0 0 0 10 10 0 0 0 0 0 0 0 0 10 10 0
0 1 1 0 0 0 10 10 10 10 0 0 0 0 0 0 10 10 0 0
0 0 0 0 0 10 10 10 10 10 0 0 0 0 0 0 10 10 10 0
0 0 0 0 0 0 0 0 0 0 0 0 0 0 0 0 0 0 0 0